TCA,OpponentQPct,W,L,T,Matches
6,0.97,0,0,2,2
5,0.97,0,4,0,4
4,0.97,0,3,0,3
3,0.97,0,5,0,5
1,0.97,0,7,0,7
0,0.97,0,1,0,1
6,0.96,1,0,4,5
5,0.96,0,4,0,4
4,0.96,0,12,0,12
3,0.96,0,1,0,1
1,0.96,0,1,0,1
6,0.95,6,0,16,22
5,0.95,3,25,8,36
4,0.95,1,25,1,27
3,0.95,0,11,0,11
6,0.94,3,0,14,17
5,0.94,3,22,5,30
4,0.94,0,14,0,14
3,0.94,0,9,0,9
2,0.94,0,4,0,4
1,0.94,0,1,0,1
6,0.93,8,0,12,20
5,0.93,9,35,13,57
4,0.93,2,32,4,38
3,0.93,1,21,1,23
2,0.93,0,7,0,7
1,0.93,0,2,0,2
0,0.93,0,1,0,1
6,0.92,8,0,18,26
5,0.92,12,43,12,67
4,0.92,1,36,1,38
3,0.92,0,19,0,19
2,0.92,0,12,0,12
1,0.92,0,3,0,3
0,0.92,0,1,0,1
6,0.91,15,0,13,28
5,0.91,6,29,8,43
4,0.91,1,23,2,26
3,0.91,1,20,0,21
2,0.91,0,5,0,5
1,0.91,0,1,0,1
6,0.90,19,0,24,43
5,0.90,14,48,15,77
4,0.90,7,34,6,47
3,0.90,0,18,0,18
2,0.90,0,2,1,3
1,0.90,0,4,0,4
0,0.90,0,1,0,1
6,0.89,47,0,58,105
5,0.89,29,111,31,171
4,0.89,7,126,19,152
3,0.89,5,79,1,85
2,0.89,0,31,0,31
1,0.89,0,14,0,14
0,0.89,0,4,0,4
6,0.88,15,0,20,35
5,0.88,14,34,7,55
4,0.88,5,30,4,39
3,0.88,1,19,2,22
2,0.88,0,10,0,10
1,0.88,0,6,0,6
0,0.88,0,2,0,2
6,0.87,42,0,50,92
5,0.87,45,86,29,160
4,0.87,10,90,5,105
3,0.87,0,39,2,41
2,0.87,0,13,0,13
1,0.87,0,1,0,1
6,0.86,39,0,27,66
5,0.86,45,65,24,134
4,0.86,7,83,10,100
3,0.86,1,40,1,42
2,0.86,0,18,0,18
1,0.86,0,4,0,4
0,0.86,0,1,0,1
6,0.85,109,0,76,185
5,0.85,108,149,71,328
4,0.85,19,196,29,244
3,0.85,2,94,5,101
2,0.85,0,26,1,27
1,0.85,0,10,0,10
0,0.85,0,4,0,4
6,0.84,38,0,25,63
5,0.84,35,50,27,112
4,0.84,10,64,11,85
3,0.84,2,36,3,41
2,0.84,0,13,0,13
1,0.84,0,3,0,3
0,0.84,0,1,0,1
6,0.83,88,0,50,138
5,0.83,89,108,57,254
4,0.83,27,157,28,212
3,0.83,5,69,2,76
2,0.83,1,35,1,37
1,0.83,0,6,0,6
0,0.83,0,3,0,3
6,0.82,41,0,27,68
5,0.82,59,60,13,132
4,0.82,14,85,5,104
3,0.82,1,51,1,53
2,0.82,0,14,1,15
1,0.82,0,10,0,10
0,0.82,0,6,0,6
6,0.81,101,0,40,141
5,0.81,111,119,52,282
4,0.81,26,142,28,196
3,0.81,5,69,6,80
2,0.81,0,45,0,45
1,0.81,0,16,0,16
0,0.81,0,8,0,8
6,0.80,71,0,31,102
5,0.80,104,103,36,243
4,0.80,27,92,21,140
3,0.80,4,68,4,76
2,0.80,0,14,1,15
1,0.80,0,5,0,5
6,0.79,199,0,77,276
5,0.79,177,154,96,427
4,0.79,64,250,62,376
3,0.79,14,148,11,173
2,0.79,2,59,4,65
1,0.79,0,11,0,11
0,0.79,0,6,0,6
6,0.78,74,0,23,97
5,0.78,51,62,33,146
4,0.78,35,100,23,158
3,0.78,6,55,5,66
2,0.78,0,27,1,28
1,0.78,0,10,0,10
0,0.78,0,7,0,7
6,0.77,182,0,52,234
5,0.77,200,149,87,436
4,0.77,99,262,66,427
3,0.77,14,190,20,224
2,0.77,2,93,2,97
1,0.77,0,37,1,38
0,0.77,0,15,0,15
6,0.76,97,0,35,132
5,0.76,125,89,43,257
4,0.76,55,127,42,224
3,0.76,11,102,11,124
2,0.76,1,34,0,35
1,0.76,1,10,0,11
0,0.76,0,10,0,10
6,0.75,181,0,45,226
5,0.75,238,165,98,501
4,0.75,106,299,66,471
3,0.75,22,227,24,273
2,0.75,6,105,2,113
1,0.75,1,34,0,35
0,0.75,0,12,0,12
6,0.74,110,0,29,139
5,0.74,153,97,44,294
4,0.74,78,189,45,312
3,0.74,25,126,22,173
2,0.74,4,85,2,91
1,0.74,1,29,2,32
0,0.74,0,18,0,18
6,0.73,254,0,50,304
5,0.73,326,183,126,635
4,0.73,179,347,106,632
3,0.73,37,276,33,346
2,0.73,4,128,5,137
1,0.73,1,33,1,35
0,0.73,0,14,0,14
6,0.72,117,0,23,140
5,0.72,173,77,64,314
4,0.72,100,155,41,296
3,0.72,27,144,23,194
2,0.72,6,88,7,101
1,0.72,0,31,1,32
0,0.72,0,9,0,9
6,0.71,137,0,31,168
5,0.71,242,89,82,413
4,0.71,121,225,76,422
3,0.71,28,216,25,269
2,0.71,5,113,5,123
1,0.71,1,37,1,39
0,0.71,0,9,2,11
6,0.70,90,0,14,104
5,0.70,164,77,47,288
4,0.70,116,175,43,334
3,0.70,28,145,19,192
2,0.70,6,82,6,94
1,0.70,0,38,0,38
0,0.70,0,8,0,8
6,0.69,185,0,32,217
5,0.69,335,123,109,567
4,0.69,234,329,107,670
3,0.69,47,281,53,381
2,0.69,12,191,23,226
1,0.69,1,92,0,93
0,0.69,0,32,0,32
6,0.68,130,0,17,147
5,0.68,200,78,48,326
4,0.68,134,173,63,370
3,0.68,47,197,36,280
2,0.68,6,97,11,114
1,0.68,1,48,2,51
0,0.68,0,11,0,11
6,0.67,188,0,36,224
5,0.67,408,130,92,630
4,0.67,270,350,137,757
3,0.67,102,404,71,577
2,0.67,22,251,14,287
1,0.67,0,81,3,84
0,0.67,0,27,0,27
6,0.66,95,0,18,113
5,0.66,236,68,58,362
4,0.66,163,198,71,432
3,0.66,66,246,42,354
2,0.66,10,174,17,201
1,0.66,0,61,2,63
0,0.66,0,13,0,13
6,0.65,202,0,21,223
5,0.65,408,112,90,610
4,0.65,318,327,132,777
3,0.65,96,403,85,584
2,0.65,24,269,21,314
1,0.65,1,125,2,128
0,0.65,0,41,0,41
6,0.64,78,0,9,87
5,0.64,179,44,37,260
4,0.64,176,179,63,418
3,0.64,76,218,40,334
2,0.64,14,152,8,174
1,0.64,4,75,2,81
0,0.64,0,27,0,27
6,0.63,206,0,26,232
5,0.63,498,120,97,715
4,0.63,418,435,190,1043
3,0.63,163,521,113,797
2,0.63,39,351,51,441
1,0.63,5,161,7,173
0,0.63,0,49,0,49
6,0.62,89,0,11,100
5,0.62,232,51,40,323
4,0.62,201,162,86,449
3,0.62,75,219,36,330
2,0.62,20,163,21,204
1,0.62,2,71,4,77
0,0.62,0,20,0,20
6,0.61,158,0,14,172
5,0.61,455,77,68,600
4,0.61,400,302,134,836
3,0.61,180,485,110,775
2,0.61,39,339,59,437
1,0.61,9,158,7,174
0,0.61,0,45,1,46
6,0.60,78,0,5,83
5,0.60,220,50,38,308
4,0.60,207,173,89,469
3,0.60,98,224,50,372
2,0.60,37,168,25,230
1,0.60,4,104,4,112
0,0.60,0,33,0,33
6,0.59,134,0,10,144
5,0.59,389,67,70,526
4,0.59,412,309,155,876
3,0.59,228,473,120,821
2,0.59,59,406,60,525
1,0.59,14,218,20,252
0,0.59,0,82,1,83
6,0.58,56,0,3,59
5,0.58,189,26,28,243
4,0.58,224,173,86,483
3,0.58,122,242,61,425
2,0.58,38,198,35,271
1,0.58,0,126,6,132
0,0.58,0,34,0,34
6,0.57,116,0,7,123
5,0.57,453,49,87,589
4,0.57,525,330,174,1029
3,0.57,305,674,177,1156
2,0.57,107,502,77,686
1,0.57,16,327,28,371
0,0.57,0,106,0,106
6,0.56,41,0,3,44
5,0.56,198,36,31,265
4,0.56,275,141,77,493
3,0.56,135,304,100,539
2,0.56,48,282,37,367
1,0.56,10,151,13,174
0,0.56,0,59,1,60
6,0.55,138,0,11,149
5,0.55,439,67,63,569
4,0.55,607,327,175,1109
3,0.55,360,572,168,1100
2,0.55,141,552,104,797
1,0.55,17,271,27,315
0,0.55,0,91,3,94
6,0.54,59,0,2,61
5,0.54,202,30,26,258
4,0.54,302,165,75,542
3,0.54,202,279,91,572
2,0.54,53,286,59,398
1,0.54,17,142,19,178
0,0.54,0,50,3,53
6,0.53,97,0,3,100
5,0.53,436,40,64,540
4,0.53,558,270,166,994
3,0.53,403,622,192,1217
2,0.53,166,625,90,881
1,0.53,25,345,38,408
0,0.53,0,143,8,151
6,0.52,50,0,1,51
5,0.52,200,22,30,252
4,0.52,282,105,76,463
3,0.52,181,282,95,558
2,0.52,70,252,61,383
1,0.52,10,155,16,181
0,0.52,0,65,3,68
6,0.51,72,0,6,78
5,0.51,392,32,38,462
4,0.51,609,241,150,1000
3,0.51,446,565,168,1179
2,0.51,180,627,136,943
1,0.51,30,369,43,442
0,0.51,0,133,7,140
6,0.50,40,0,1,41
5,0.50,210,11,14,235
4,0.50,324,136,76,536
3,0.50,256,302,105,663
2,0.50,119,397,69,585
1,0.50,18,256,34,308
0,0.50,0,93,8,101
6,0.49,92,0,3,95
5,0.49,398,32,40,470
4,0.49,648,208,155,1011
3,0.49,555,628,240,1423
2,0.49,227,715,177,1119
1,0.49,46,512,65,623
0,0.49,0,165,12,177
6,0.48,39,0,0,39
5,0.48,162,12,16,190
4,0.48,282,113,55,450
3,0.48,260,285,103,648
2,0.48,92,355,100,547
1,0.48,30,263,25,318
0,0.48,0,100,3,103
6,0.47,68,0,4,72
5,0.47,368,19,38,425
4,0.47,638,221,154,1013
3,0.47,606,594,204,1404
2,0.47,282,664,161,1107
1,0.47,48,543,87,678
0,0.47,0,193,12,205
6,0.46,36,0,0,36
5,0.46,166,14,20,200
4,0.46,367,113,66,546
3,0.46,311,259,124,694
2,0.46,159,392,102,653
1,0.46,45,308,49,402
0,0.46,0,100,8,108
6,0.45,50,0,2,52
5,0.45,302,20,20,342
4,0.45,570,145,113,828
3,0.45,525,486,208,1219
2,0.45,272,617,166,1055
1,0.45,71,514,80,665
0,0.45,0,198,16,214
6,0.44,44,0,1,45
5,0.44,193,11,12,216
4,0.44,397,79,81,557
3,0.44,383,274,132,789
2,0.44,175,421,93,689
1,0.44,46,296,54,396
0,0.44,0,107,9,116
6,0.43,58,0,0,58
5,0.43,272,9,23,304
4,0.43,597,127,92,816
3,0.43,579,471,226,1276
2,0.43,335,665,220,1220
1,0.43,92,567,94,753
0,0.43,0,219,30,249
6,0.42,31,0,0,31
5,0.42,170,6,13,189
4,0.42,388,73,55,516
3,0.42,378,251,114,743
2,0.42,209,389,96,694
1,0.42,51,294,71,416
0,0.42,0,128,12,140
6,0.41,33,0,0,33
5,0.41,236,8,14,258
4,0.41,522,97,91,710
3,0.41,576,380,191,1147
2,0.41,334,618,183,1135
1,0.41,99,567,136,802
0,0.41,0,250,29,279
6,0.40,28,0,0,28
5,0.40,127,6,8,141
4,0.40,266,46,50,362
3,0.40,299,184,93,576
2,0.40,170,312,91,573
1,0.40,65,301,75,441
0,0.40,0,123,20,143
6,0.39,30,0,1,31
5,0.39,188,5,17,210
4,0.39,510,89,73,672
3,0.39,633,350,184,1167
2,0.39,379,651,227,1257
1,0.39,133,638,150,921
0,0.39,0,287,56,343
6,0.38,23,0,0,23
5,0.38,131,4,8,143
4,0.38,319,36,47,402
3,0.38,375,187,87,649
2,0.38,214,332,100,646
1,0.38,69,260,68,397
0,0.38,0,145,22,167
6,0.37,42,0,0,42
5,0.37,256,9,6,271
4,0.37,506,93,68,667
3,0.37,646,335,194,1175
2,0.37,453,563,232,1248
1,0.37,132,608,146,886
0,0.37,0,283,62,345
6,0.36,16,0,0,16
5,0.36,92,6,5,103
4,0.36,256,30,28,314
3,0.36,361,162,116,639
2,0.36,217,295,117,629
1,0.36,83,308,73,464
0,0.36,0,148,31,179
6,0.35,38,0,2,40
5,0.35,176,5,9,190
4,0.35,545,55,61,661
3,0.35,661,282,173,1116
2,0.35,491,568,241,1300
1,0.35,140,644,188,972
0,0.35,0,305,84,389
6,0.34,12,0,0,12
5,0.34,80,0,4,84
4,0.34,200,21,22,243
3,0.34,292,104,72,468
2,0.34,191,241,97,529
1,0.34,77,258,74,409
0,0.34,0,135,34,169
6,0.33,19,0,1,20
5,0.33,180,3,4,187
4,0.33,466,56,58,580
3,0.33,667,255,159,1081
2,0.33,548,568,251,1367
1,0.33,198,599,197,994
0,0.33,0,339,88,427
6,0.32,9,0,0,9
5,0.32,77,3,1,81
4,0.32,192,20,15,227
3,0.32,311,112,74,497
2,0.32,228,257,119,604
1,0.32,84,283,105,472
0,0.32,0,156,36,192
6,0.31,18,0,0,18
5,0.31,136,1,2,139
4,0.31,365,33,35,433
3,0.31,584,212,128,924
2,0.31,451,413,196,1060
1,0.31,191,473,193,857
0,0.31,0,267,89,356
6,0.30,9,0,0,9
5,0.30,62,3,4,69
4,0.30,173,9,19,201
3,0.30,265,84,49,398
2,0.30,181,172,69,422
1,0.30,91,207,88,386
0,0.30,0,114,53,167
6,0.29,16,0,2,18
5,0.29,113,0,4,117
4,0.29,297,31,23,351
3,0.29,494,134,105,733
2,0.29,433,363,215,1011
1,0.29,237,460,185,882
0,0.29,0,245,109,354
6,0.28,9,0,0,9
5,0.28,60,0,1,61
4,0.28,154,9,8,171
3,0.28,263,56,48,367
2,0.28,218,154,83,455
1,0.28,103,193,89,385
0,0.28,0,112,45,157
6,0.27,15,0,0,15
5,0.27,75,1,1,77
4,0.27,240,13,15,268
3,0.27,457,87,69,613
2,0.27,364,249,143,756
1,0.27,187,360,168,715
0,0.27,0,191,102,293
6,0.26,7,0,0,7
5,0.26,43,2,0,45
4,0.26,150,7,10,167
3,0.26,261,57,39,357
2,0.26,271,174,88,533
1,0.26,101,209,116,426
0,0.26,0,144,64,208
6,0.25,14,0,0,14
5,0.25,86,1,2,89
4,0.25,287,17,15,319
3,0.25,485,96,84,665
2,0.25,488,244,158,890
1,0.25,193,351,188,732
0,0.25,0,215,118,333
6,0.24,15,0,0,15
5,0.24,56,1,0,57
4,0.24,153,10,16,179
3,0.24,226,52,42,320
2,0.24,253,115,86,454
1,0.24,112,179,98,389
0,0.24,0,121,72,193
6,0.23,14,0,0,14
5,0.23,93,0,0,93
4,0.23,270,7,12,289
3,0.23,495,76,66,637
2,0.23,452,223,154,829
1,0.23,244,316,187,747
0,0.23,0,179,130,309
6,0.22,7,0,0,7
5,0.22,30,0,0,30
4,0.22,99,2,5,106
3,0.22,173,19,30,222
2,0.22,198,84,59,341
1,0.22,105,127,85,317
0,0.22,0,79,61,140
6,0.21,12,0,0,12
5,0.21,66,0,3,69
4,0.21,250,6,7,263
3,0.21,396,46,47,489
2,0.21,407,148,99,654
1,0.21,180,222,165,567
0,0.21,0,134,114,248
6,0.20,4,0,0,4
5,0.20,32,0,0,32
4,0.20,86,3,5,94
3,0.20,154,15,25,194
2,0.20,176,64,51,291
1,0.20,96,94,79,269
0,0.20,0,58,47,105
6,0.19,9,0,0,9
5,0.19,50,0,1,51
4,0.19,136,3,6,145
3,0.19,234,23,22,279
2,0.19,240,78,71,389
1,0.19,128,122,84,334
0,0.19,0,101,88,189
6,0.18,5,0,0,5
5,0.18,12,0,0,12
4,0.18,53,1,2,56
3,0.18,83,5,7,95
2,0.18,95,32,26,153
1,0.18,45,37,27,109
0,0.18,0,31,19,50
6,0.17,10,0,0,10
5,0.17,43,0,1,44
4,0.17,154,5,4,163
3,0.17,208,17,19,244
2,0.17,244,56,53,353
1,0.17,116,104,92,312
0,0.17,0,66,65,131
6,0.16,3,0,0,3
5,0.16,18,0,0,18
4,0.16,43,1,3,47
3,0.16,84,4,10,98
2,0.16,94,26,21,141
1,0.16,39,26,34,99
0,0.16,0,30,31,61
6,0.15,5,0,0,5
5,0.15,25,0,0,25
4,0.15,115,3,5,123
3,0.15,171,19,15,205
2,0.15,179,40,27,246
1,0.15,95,72,77,244
0,0.15,0,42,77,119
6,0.14,5,0,1,6
5,0.14,9,2,0,11
4,0.14,45,0,2,47
3,0.14,64,0,6,70
2,0.14,81,15,14,110
1,0.14,34,28,19,81
0,0.14,0,17,27,44
6,0.13,4,0,0,4
5,0.13,11,0,0,11
4,0.13,41,0,0,41
3,0.13,81,3,4,88
2,0.13,89,16,16,121
1,0.13,50,27,38,115
0,0.13,0,24,27,51
5,0.12,4,0,0,4
4,0.12,14,1,1,16
3,0.12,26,2,1,29
2,0.12,28,7,2,37
1,0.12,14,4,5,23
0,0.12,0,11,5,16
6,0.11,2,0,0,2
5,0.11,19,0,0,19
4,0.11,51,0,0,51
3,0.11,89,4,7,100
2,0.11,102,7,12,121
1,0.11,55,24,37,116
0,0.11,0,27,39,66
5,0.10,3,0,0,3
4,0.10,6,0,0,6
3,0.10,17,0,2,19
2,0.10,20,6,5,31
1,0.10,14,6,3,23
0,0.10,0,5,10,15
6,0.09,1,0,0,1
5,0.09,6,0,0,6
4,0.09,21,0,0,21
3,0.09,30,2,1,33
2,0.09,40,2,6,48
1,0.09,15,10,13,38
0,0.09,0,6,19,25
5,0.08,1,0,0,1
4,0.08,3,0,0,3
3,0.08,6,2,0,8
2,0.08,7,2,0,9
1,0.08,4,1,6,11
0,0.08,0,1,5,6
6,0.07,2,0,0,2
5,0.07,11,0,0,11
4,0.07,19,0,0,19
3,0.07,43,1,1,45
2,0.07,43,2,1,46
1,0.07,16,5,11,32
0,0.07,0,4,8,12
6,0.06,2,0,0,2
5,0.06,2,0,0,2
4,0.06,6,0,0,6
3,0.06,12,1,0,13
2,0.06,9,1,1,11
1,0.06,6,2,9,17
0,0.06,0,2,10,12
5,0.05,4,0,0,4
4,0.05,12,0,0,12
3,0.05,17,1,1,19
2,0.05,25,2,2,29
1,0.05,9,1,5,15
0,0.05,0,3,4,7
5,0.04,2,0,0,2
4,0.04,1,0,0,1
3,0.04,6,0,0,6
2,0.04,7,1,0,8
1,0.04,1,4,0,5
0,0.04,0,1,0,1
5,0.03,9,0,0,9
4,0.03,12,0,0,12
3,0.03,15,0,0,15
2,0.03,20,1,2,23
1,0.03,13,1,4,18
0,0.03,0,1,5,6
6,0.02,1,0,0,1
5,0.02,1,0,0,1
4,0.02,2,0,0,2
2,0.02,1,0,0,1
1,0.02,1,0,1,2
0,0.02,0,1,1,2
6,0.01,1,0,0,1
5,0.01,1,0,0,1
4,0.01,5,0,0,5
3,0.01,12,0,0,12
2,0.01,8,1,0,9
1,0.01,7,1,1,9
0,0.01,0,1,0,1
6,0.00,2,0,0,2
5,0.00,10,0,0,10
4,0.00,32,0,0,32
3,0.00,31,0,0,31
2,0.00,26,0,0,26
1,0.00,5,0,2,7
0,0.00,0,0,3,3
